40
================
=X=       =@   =
=         =    =
=W        =   M=
=         ==!===
=         =    =
====      =    =
=  *    T #    =
=K *      =   X=
================