90
====================
=X  K=W  =T      ===
=    =   #       !X=
=****=====       ===
=               ^ X=
====================
=    =      *      =
=    =      *      =
=    * ^    * ======
=    *      * #    =
=    =      * = ***=
=    =      * = *  =
=X   = FM   * = * @=
====================