30
==============
=K  =        =
=   =     ====
=   *    !M @=
=   *     ====
=   =        =
=   =W       =
==============