30
===================
=       =  X   ^  =
=  ^ X  =         =
=       =         =
=       =       @ =
=   X   =         =
=       =    X    =
=K   ^  =      ^  =
===================